SO ./path_to_the_south_textureSO
NO ./path_to_the_south_texture
WE a b
EA ./path_to_the_east_texture
F 220 , 100, 0
C 225 , 30, 0

        11
    1111W01
        11
        11
   